-19
19
-8
8
000000000000000000000000000000000000000
111111111111111111111111111111111111110
000000000000000000000000000000000000000
000000000000000000000000000000000000000
000000000000000000000000000000000000000
000000000000000000000000000000000000000
000000000000000000000000000001000000000
000000000000000000000000111111100000000
000000111110000000000000111111100000000
000001100000000000000000111111100000000
000000111110000000000000111111100000000
000000000000000000000000111111100000000
000000000000000000000000111111100000000
000000000000000000000000111111100000000
000000000000000000000000000000000000000
000000000000000000000000000000000000000
000000000000000000000000000000000000000
